11 12
000001100000
000022220000
000111111000
002222222200
011111111110
222222222222
011111111110
002222222200
000111111000
000022220000
000001100000